1111111111111
1P00010000001
1000010000001
1C00000E00001
1111111111111