1111111111111
1P00010000001
1000010000001
110C000E00001
1000000000001
1000000000001
1000000000001
1000000000001
1000000000001
1111111111111