1111111111111
1000000000001
1000000000001
1011000111101
10101C01C0001
1P10010111101
10101C000C101
1011000111101
10000C0000001
1E00000000001
1111111111111