111111
1E0P11
1C0001
100001
100001
111111